1111111111000000000000000000000000000000000000000000000000000000000000000000000000000000000000000000000000000000000000000000000000000000000000000000000000000000000000000000000000000000000000000000000000000000000000000000000000000000000000000000000000000000000000000000000000000000000000000000000000000000000001
1111111111000000000000000000000000000000000000000000000000000000000000000000000000000000000000000000000000000000000000000000000000000000000000000000000000000000000000000000000000000000000000000000000000000000000000000000000000000000000000000000000000000000000000000000000000000000000000000000000000000000000001
1111111111000000000000000000000000000000000000000000000000000000000000000000000000000000000000000000000000000000000000000000000000000000000000000000000000000000000000000000000000000000000000000000000000000000000000000000000000000000000000000000000000000000000000000000000000000000000000000000000000000000000001
1111111111000000000000000000000000000000000000000000000000000000000000000000000000000000000000000000000000000000000000000000000000000000000000000000000000000000000000000000000000000000000000000000000000000000000000000000000000000000000000000000000000000000000000000000000000000000000000000000000000000000000001
1111111111000000000000000000000000000000000000000000000000000000000000000000000000000000000000000000000000000000000000000000000000000000000000000000000000000000000000000000000000000000000000000000000000000000000000000000000000000000000000000000000000000000000000000000000000000000000000000000000000000000000001
1111111111000000000000000000000000000000000000000000000000000000000000000000000000000000000000000000000000000000000000000000000000000000000000000000000000000000000000000000000000000000000000000000000000000000000000000000000000000000000000000000000000000000000000000000000000000000000000000000000000000000000001
1111111111000000000000000000000000000000000000000000000000000000000000000000000000000000000000000000000000000000000000000000000000000000000000000000000000000000000000000000000000000000000000000000000000000000000000000000000000000000000000000000000000000000000000000000000000000000000000000000000000000000000001
1111111111000000000000000000000000000000000000000000000000000000000000000000000000000000000000000000000000000000000000000000000000000000000000000000000000000000000000000000000000000000000000000000000000000000000000000000000000000000000000000000000000000000000000000000000000000000000000000000000000000000000001
1111111111000000000000000000000000000000000000000000000000000000000000000000000000000000000000000000000000000000000000000000000000000000000000000000000000000000000000000000000000000000000000000000000000000000000000000000000000000000000444444400000000000000000000000000000000000000000000000000000000000000000001
1111111111000000000000000000000000000000000000000000000000000000000000000000000000000000000000000000000000000000000000000000000000000000000000000000000000000000000000000000000000000000000000000000000000000000000000000000000000000000044444444444000000000000000000000000000000000000000000000000000000000000000001
1111111111000000000000000000000000000000000000000000000000000000000000000000000000000000000000000000000000000000000000000000000000000000000000000000000000000000000000000000000000000000000000000000000000000000000000000000000000000004444444444444400000000000000000000000000000000000000000000000000000000000000001
1111111111000000000000000000000000000000000000000000000000000000000000000000000000000000000000000000000000000000000000000000000000000000000000000000000000000000000000000000000000000000000000000000000000000000000000000000000000000000000000000000000000000000000000000000000000000000000000000000000000000000000001
1111111111000000000000000000000000000000000000000000000000000000000000000000000000000000000000000000000000000000000000000000000000000000000000000000000000000000000000000000000000000000000000000000000000000000000000000044440000000000000000000000000000000000000000000000000000000000000000000000000000000000000001
1111111111000000000000000000000000000000000000000000000000000000000000000000000000000000000000000000000000000000000000000000000000000000000000000000000000000000000000000000000000000000000000000000000000000000000000000044444400000000000444400000000000000000000000000000000000000000000000000000000000000000000001
1111111111000000000000000000000000000000000000000000000000000000000000000000000000000000000000000000000000000000000000000000000000000000000000000000000000000000000000000000000000000000000000000000000000000000000000000000000000000000000444400000000000000000000000000000000000000000000000000000000000000000000001
1111111111000000000000000000000000000000000000000000000000000000000000000000000000000000000000000000000000000000000000000000000000000000000000000000000000000000000000000000000000000000000000000000000000000000000000000000000000000000000444400000000444444400000000000000000000000000000000000000000000000000000001
1111111111000000000000000000000000000000000000000000000000000000000000000000000000000000000000000000000000000000000000000000000000000000000000000000000000000000000000000000000000000000000000000000000000000000000000000000000000000000000444400000044444444440000000000000000000000000000000000000000000000000000001
1111111111000000000000000000000000000000000000000000000000000000000000000000000000000000000000000000000000000000000000000000000000000000000000000000000000000000000000000000000000000000000000000000000000000000000000000000000000000000000444400000000000000000000000000000000000000000000000000000000000000000000001
1111111111000000000000000000000000000000000000000000000000000000000000000000000000000000000000000000000000000000000000000000000000000000000000000000000000000000000000000000000000000000000000000000000000000000000000000000000000000004444444400000000000000000000000000000000000000000000000000000000000000000000001
1111111111000000000000000000000000000000000000000000000000000000000000000000000000000000000000000000000000000000000000000000000000000000000000000000000000000000000000000000000000000000000000000000000000000000000000000000000000004444444444400000000000000000000000000000000000000000000000000000000000000000000001
1111111111000000000000000000000000000000000000000000000000000000000000000000000000000000000000000000000000000000000000000000000000000000000000000000000000000000000000000000000000000000000000000000000000000000000000000000000000000000000000000000000000000000000444440000000000000000000000000000000000000000000001
1111111111000000000000000000000000000000000000000000000000000000000000000000000000000000000000000000000000000000000000000000000000000000000000000000000000000000000000000000000000000000000000000000000000000000000000000000000000000000000000000000000000000000004444444400000000000000000000000000000000000000000001
1111111111000000000000000000000000000000000000000000000000000000000000000000000000000000000000000000000000000000000000000000000000000000000000000000000000000000000000000000000000000000000000000000000000000000000000000044444400000000000000000000000000000000044444444440000000000000000000000000000000000000000001
1111111111000000000000000000000000000000000000000000000000000000000000000000000000000000000000000000000000000000000000000000000000000000000000000000000000000000000000000000000000000000000000000000000000000000000000000444444440000000000000000000000000000000000000000000000000000000000000000000000000000000000001
1111111111000000000000000000000000000000000000000000000000000000000000000000000000000000000000000000000000000000000000000000000000000000000000000000000000000000000000000000000000000000000000000000000000000000000000000000000000000000000000000000000000000000000000000000000000000000000000000000000000000000000001
1111111111000000000000000000000000000000000000000000000000000000000000000000000000000000000000000000000000000000000000000000000000000000000000000000000000000000000000000000000000000000000000000000000000000000000000000000000000000000000000000000000000000000000000000000000000000000000000000000000000000000000001
1111111111000000000000000000000000000000000000000000000000000000000000000000000000000000000000000000000000000000000000000000000000000000000000000000000000000000000000000000000000000000000000000000000000000000000000000000000000000000000000000000000000000000000000000000000000000000000000000000000000000000000001
1111111111000000000000000000000000000000000000000000000000000000000000000000000000000000000000000000000011110000111100000112222111000000000000000000000000000000000000000000000000000000000000000000000000000000444400000000000000000000000000000000000000000000000000000000000000000000000000000000000000000000000091
1111111111000000000000000000000000000000000000000000000000000000000000000000000000000000000000000000000000000000000000000000000000000000212100000000000000000000000000000000000000000000000000000000000000000000004444440000000000000000000000000000000000000000000000000000000000000000000000000000000000000000000111
1111111111000000000000000000000110000000000000000000000000000000000000000000000000000000000000002222000000000000000000000000000000000000000000000000000000000000000000000000000000000000000000000000000000000000000000000000000000000000000000000000000000000000000000000000000000000000000000000000000000000000001111
1111111111000000000000000000001112222000000000000000000000000000000000000000000000000000000000000000000000000000000000000000000000000000000000000000000000000000000000000000000000000000000000000000000000000000000000000440000000000000000000000000000000000000000000000000000000000000000000000000000000000000011111
1111111111000000000000000000111111111000000000000000000000000000222222222200000000000000011111000000000000000000000000000000000000001210000000000000000000000000000000000000000000000000000000000000000000000000000000004444400000000000000000000000000000000000000000000000000000000000000000000000000000000000111111
1111111111000000000000000001111111111000000000000000000000000000000000000000000000000000000000000000000000000000000000000000000000000000000000000000000000000000000000000000000000000000000000000000000000000000000000000000000000000000000000000000000000000000000000000000000000000000000000000000000000000001111111
1111111111000000000000001111111111111000000000000000000000000000000000000000000000000000000000000000000000000000000000000000000000000000000000000000000000000000000000000000000000000000000000000000000000000000000000000000000000000000000000000000000000000000000000000000000000000000000000008000000000000011111111
1111111111111111111111111111111111111122222222221111111111111111111000222221111111111110000000000000000000000000000000000000000000000000000000000002222222222221112221112221111222221111111112222222222222211110000011111100000000000000000000000000000000000000000000000000000000000011111111111111111111111111111199
1111111111111111111111111111111111111111111111111111111111111111111000111111111111111110000000000000000000000000000000000000000000000000000000000001111111111111111111111111111111111111111111111111111111111111000111111100000000000000000000000000000000000000000000000000000000000011111111111111111111111111111111
1111111111111111111111111111111111111111111111111111111111111111111000111111111111111110000000000000000000000000000000000000000000000000000000000001111111111111111111111111111111111111111111111111111111111111000111111100000000000000000000000000000000000000000000000000000000000011111111111111111111111111111111
1111111111111111111111111111111111111111111111111111111111111111111000111111111111111110000000000000000000000000000000000000000000000000000000000001111111111111111111111111111111111111111111111111111111111111000111111100000000000000000000000000000000000000000000000000000000000011111111111111111111111111111111
1111111111111111111111111111111111111111111111111111111111111111111000111111111111111110000000000000000000000000000000000000000000000000000000000001111111111111111111111111111111111111111111111111111111111111000111111100000000000000000000000000000000000000000000000000000000000011111111111111111111111111111111
1111111111111111111111111111111111111111111111111111111111111111111000111111111111111110000000000000000000000000000000000000000000000000000000000001111111111111111111111111111111111111111111111111111111111111000111111100000000000000000000000000000000000000000000000000000000000011111111111111111111111111111111
1111111111111111111111111111111111111111111111111111111111111111111000111111111111111110000000000000000000000000000000000000000000000000000000000001111111111111111111111111111111111111111111111111111111111111000111111100000000000000000000000000000000000000000000000000000000000011111111111111111111111111111111
1111111111111111111111111111111111111111111111111111111111111111111000111111111111111110000000000000000000000000000000000000000000000000000000000001111111111111111111111111111111111111111111111111111111111111000111111100000000000000000000000000000000000000000000000000000000000011111111111111111111111111111111
1111111111111111111111111111111111111111111111111111111111111111111000111111111111111110000000000000000000000000000000000000000000000000000000000001111111111111111111111111111111111111111111111111111111111111000111111100000000000000000000000000000000000000000000000000000000000011111111111111111111111111111111
1111111111111111111111111111111111111111111111111111111111111111111000111111111111111110000000000000000000000000000000000000000000000000000000000001111111111111111111111111111111111111111111111111111111111111000111111100000000000000000000000000000000000000000000000000000000000011111111111111111111111111111111
1111111111111111111111111111111111111111111111111111111111111111111000111111111111111110000000000000000000000000000000000000000000000000000000000000000000000000000000000000000000000000000111111111111111111111000111111100000000000000000000000000000000000000000000000000000000000011111111111111111111111111111111
111111111111111111111111111111111111111111111111111111111111111111100011111111111111111000000000000000000000000000000000000000000000000000000000000000000000000000000000000000000000000000011111111111111111111100011111110000000000000000000000000000000000000000000000000000000000001111111111111111111111111111111
1111111111111111111111111111111111111111111111111111111111111111111000111111111111111110000000000000000000000000000000000000000000000000000000000001111111111111111111111111111111111111000111111111111111111110001111111100000000000000000000000000000000000000000000000000000000000011111111111111111111111111111111
1111111111111111111111111111111111111111111111111111111111111111111000111111111111111110000000000000000000000000000000000000000000000000000000000001111111111111111111111111111111111111000111111111111111111110001111111100000000000000000000000000000000000000000000000000000000000011111111111111111111111111111111
1111111111111111111111111111111111111111111111111111111111111111111000111111111111111110000000000000000000000000000000000000000000000000000000000001111111111111111111111111111111111111000111111111111111111100011111111100000000000000000000000000000000000000000000000000000000000011111111111111111111111111111111
1111111111111111111111111111111111111111111111111111111111111111111000111111111111111110000000000000000000000000000000000000000000000000000000000001111111111111111111111111111111111111000111111111111111111100011111111100000000000000000000000000000000000000000000000000000000000011111111111111111111111111111111
1111111111111111111111111111111111111111111111111111111111111111111000111111111111111110000000000000000000000000000000000000000000000000000000000001111111111111111111111111111111111111000111111111111111111000111111111100000000000000000000000000000000000000000000000000000000000011111111111111111111111111111111
1111111111111111111111111111111111111111111111111111111111111111111000111111111111111110000000000000000000000000000000000000000000000000000000000001111111111111111111111111111111111111000111111111111111110001111111111100000000000000000000000000000000000000000000000000000000000011111111111111111111111111111111
1111111111111111111111111111111111111111111111111111111111111111111000111111111111111110000000000000000000000000000000000000000000000000000000000001111111111111111111111111111111111110000000000000000000000001111111111100000000000000000000000000000000000000000000000000000000000011111111111111111111111111111111
111111111111111111111111111111111111111111111111111111111111111111100011111111111111111000000000000000000000000000000000000000000000000000000000000111111111111111111111111111111111111000000000000000000000000111111111110000000000000000000000000000000000000000000000000000000000001111111111111111111111111111111
111111111111111111111111111111111111111111111111111111111111111111100011111111111111111000000000000000000000000000000000000000000000000000000000000111111111111111111111111111111111111111111111111111111111111111111111110000000000000000000000000000000000000000000000000000000000001111111111111111111111111111111

